140 100
#                                                                                                                                          #
#                                                                                                                                          #
#                                                                                                                                          #
#                                                                                                                                          #
#                                                                                                                                          #
#                                                                                                                                          #
#                                                                                                                                          #
#                                                                                                                                          #
#                                                                                                                                          #
#                                                                                                                                          #
#                                                                                                                                          #
#                                                                                                                                          #
#                                                                                                                                          #
#                                                                                                                                          #
#                                                                                                                                          #
#                                                                                                                                          #
#                                                                                                                                          #
#                                                                                                                                          #
#                                                                                                                                          #
#                                                                                                                                          #
#                                                                                                                                          #
#                                                                                                                                          #
#                                                                                                                                          #
#                                                                                                                                          #
#                                                                                                                                          #
#                                                                                                                                          #
#                                                                                                                                          #
#                                                                                                                                          #
#                                                                                                                                          #
#                                                                                                                                          #
#                                                                                                                                          #
                                                 #######################################
                                                 #.....................................#
                                                 #.....................................#
                                                 #.....................................#
                                                 #.....................................#
                                                 #.....................................#
                                                 #.....................................#
                                                 #......#########################......#
                                                 #......#...........#    #......#......#
                                                 #......#...s...s...######......#......#
                                                 #......#.......................#......#
                                                 #......#...........######......#......#
                                                 #......#.....s.....#    #......#......#
                                                 #......#...........#    #......#......#
                                                 #......#...........#    #......#......#
                                                 #......#####..######    ###..###......#
                                                 #......    #..#           #..#........#
                                                 #......    #..#           #..#........#
                                                 #......    #..#          ##..##.......#
                                                 #......  ###g.#|_#      #......#......#
                                                 #......  _..@...._      #......#......#
                                                 #......  |..*....|      #......#......#
                                                 #......  #..ß....#      #...*..#......#
                                                 #......  #..ß....#      #......#......#
                                                 #......  #..ß..ß.#      #......#......#
                                                 #......  #..ß..ß.#      #......#......#
                                                 #......  ##|_#####       ######.......#
                                                 #.....................................#
                                                 #.....................................#
                                                 #.....................................#
                                                 #.....................................#
                                                 #.....................................#
                                                 #.....................................#
                                                 #######################################
#                                                                                                                                          #
#                                                                                                                                          #
#                                                                                                                                          #
#                                                                                                                                          #
#                                                                                                                                          #
#                                                                                                                                          #
#                                                                                                                                          #
#                                                                                                                                          #
#                                                                                                                                          #
#                                                                                                                                          #
#                                                                                                                                          #
#                                                                                                                                          #
#                                                                                                                                          #
#                                                                                                                                          #
#                                                                                                                                          #
#                                                                                                                                          #
#                                                                                                                                          #
#                                                                                                                                          #
#                                                                                                                                          #
#                                                                                                                                          #
#                                                                                                                                          #
#                                                                                                                                          #
#                                                                                                                                          #
#                                                                                                                                          #
#                                                                                                                                          #
#                                                                                                                                          #
#                                                                                                                                          #
#                                                                                                                                          #
#                                                                                                                                          #
#                                                                                                                                          #
#                                                                                                                                          #
#                                                                                                                                          #
#                                                                                                                                          #
#                                                                                                                                          #
#                                                                                                                                          #                                                                                                                                       #
