30 20
#############
#...........#############
#...s...................#
|@......................#
#.......................#
#.....s.................#
#.......................#
#.......................#
###########..############
          #..#
          #..#
         ##..##
  #########..############
  #.....................#
  #...*.................#
  #..$...............*..#
  #.....................#
  #....................._
  #.....ß...............#
  #######################