140 100
#                                                                                                                                          #
#                                                                                                                                          #
#                                                                                                                                          #
#                                                                                                                                          #
#                                                                                                                                          #
#                                                                                                                                          #
#                                                                                                                                          #
#                                                                                                                                          #
#                                                                                                                                          #
#                                                                                                                                          #
#                                                                                                                                          #
#                                                                                                                                          #
#                                                                                                                                          #
#                                                                                                                                          #
#                                                                                                                                          #
#                                                                                                                                          #
#                                                                                                                                          #
#                                                                                                                                          #
#                                                                                                                                          #
#                                                                                                                                          #
#                                                                                                                                          #
#                                                                                                                                          #
#                                                                                                                                          #
#                                                                                                                                          #
#                                                                                                                                          #
#                                                                                                                                          #
#                                                                                                                                          #
#                                                                                                                                          #
#                                                                                                                                          #
#                                                                                                                                          #
#                                                                                                                                          #
                                                 #######################################
                                                 #....#...........#############........#
                                                 #....#...s...s...............#........#
                                                 #....|@......................#........#
                                                 #....#.......................#........#
                                                 #....#.....s.................#........#
                                                 #....#.......................#........#
                                                 #....#.......................#........#
                                                 #....###########..############........#
                                                 #......        #..#           ........#
                                                 #......        #..#           ........#
                                                 #......       ##..##          ........#
                                                 #......#########..############........#
                                                 #......#.....................#........#
                                                 #......#...*.................#........#
                                                 #......#..$...............*..#........#
                                                 #......#.....................#........#
                                                 #......#....................._........#
                                                 #......#.....ß...............#........#
                                                 #######################################
#                                                                                                                                          #
#                                                                                                                                          #
#                                                                                                                                          #
#                                                                                                                                          #
#                                                                                                                                          #
#                                                                                                                                          #
#                                                                                                                                          #
#                                                                                                                                          #
#                                                                                                                                          #
#                                                                                                                                          #
#                                                                                                                                          #
#                                                                                                                                          #
#                                                                                                                                          #
#                                                                                                                                          #
#                                                                                                                                          #
#                                                                                                                                          #
#                                                                                                                                          #
#                                                                                                                                          #
#                                                                                                                                          #
#                                                                                                                                          #
#                                                                                                                                          #
#                                                                                                                                          #
#                                                                                                                                          #
#                                                                                                                                          #
#                                                                                                                                          #
#                                                                                                                                          #
#                                                                                                                                          #
#                                                                                                                                          #
#                                                                                                                                          #
#                                                                                                                                          #
#                                                                                                                                          #
#                                                                                                                                          #
#                                                                                                                                          #
#                                                                                                                                          #
#                                                                                                                                          #
#                                                                                                                                          #
#                                                                                                                                          #
#                                                                                                                                          #
#                                                                                                                                          #
#                                                                                                                                          #
#                                                                                                                                          #
#                                                                                                                                          #
#                                                                                                                                          #
#                                                                                                                                          #
#                                                                                                                                          #
#                                                                                                                                          #
#                                                                                                                                          #
#                                                                                                                                          #
#                                                                                                                                          #